11111111111111111111111111
10100010000001000001000001
10P01000000000C01000001E01
11111111111111111111111111
