11111111111111111111111111
10100000010001000001000001
100P010000000C0010000010E1
11111111111111111111111111
